40 40 40 40 40 40 40 40 40 40 40 40 40 40 40 40 40 40 40 40 40 40 40 40 40 40 40 40 40 40 40 40 40 40 40 40 40 40 40 40 40 40 40 40 40 40 40 40 40 40
40 41 41 41 41 41 41 41 41 41 41 41 41 41 41 41 41 41 41 41 41 41 41 41 41 41 41 41 41 41 41 41 41 41 41 41 41 41 41 41 41 41 41 41 41 41 41 41 41 40
40 41 41 10 10 10 10 10 10 10 41 41 41 41 41 41 41 41 41 41 41 41 41 41 41 41 41 41 41 41 41 41 41 41 41 41 41 41 41 41 41 41 41 41 41 41 41 41 41 40
40 41 41 10 10 10 10 10 10 10 41 41 41 41 41 41 41 41 41 41 41 41 41 41 41 41 41 41 41 41 41 41 41 41 41 41 41 41 41 41 41 41 41 41 41 41 41 41 41 40
40 41 41 10 10 10 10 10 10 10 41 41 41 41 41 41 41 41 41 41 41 41 41 41 41 41 41 41 41 41 41 41 41 41 41 41 41 41 41 41 41 41 41 41 41 41 41 41 41 40
40 41 41 10 10 10 10 10 10 10 10 10 10 10 10 10 10 10 10 10 10 10 10 10 10 10 10 10 10 10 10 10 10 10 10 10 10 10 10 10 10 10 10 10 10 10 10 41 41 40
40 41 41 10 10 10 10 10 10 10 10 10 10 10 10 10 10 10 10 10 10 10 10 10 10 10 10 10 10 10 10 10 10 10 10 10 10 10 10 10 10 10 10 10 10 10 10 41 41 40
40 41 41 10 10 10 10 10 10 10 10 10 10 10 10 10 10 10 10 10 10 10 10 10 10 10 10 10 10 10 10 10 10 10 10 10 10 10 10 10 10 10 10 10 10 10 10 41 41 40
40 41 41 10 10 10 10 10 10 10 41 41 41 41 41 41 41 41 41 41 41 41 41 41 10 10 10 41 41 41 41 41 41 41 41 41 41 41 41 41 10 10 10 10 10 10 10 41 41 40
40 41 41 10 10 10 10 10 10 10 41 41 41 41 41 41 41 41 41 41 41 41 41 41 10 10 10 41 41 41 41 41 41 41 41 41 41 41 41 41 10 10 10 10 10 10 10 41 41 40
40 41 41 10 10 10 10 10 10 10 41 41 41 41 41 41 41 41 41 41 41 41 41 41 10 10 10 41 41 41 41 41 41 41 41 41 10 10 10 10 10 10 10 10 10 10 10 41 41 40
40 41 41 10 10 10 10 10 10 10 41 41 41 41 41 41 41 41 41 41 41 41 41 41 10 10 10 41 41 41 41 41 41 41 41 41 10 10 10 10 10 10 10 10 10 10 10 41 41 40
40 41 41 41 41 41 41 41 41 41 41 41 41 41 41 41 41 41 41 41 41 41 41 41 10 10 10 41 41 41 41 41 41 41 41 41 10 10 10 10 10 10 10 10 10 10 10 41 41 40
40 41 41 41 41 41 41 41 41 41 41 41 41 41 41 41 41 41 41 41 41 41 41 41 10 10 10 41 41 41 41 41 41 41 41 41 10 10 10 10 10 10 10 10 10 10 10 41 41 40
40 41 41 41 41 41 41 41 41 41 41 41 41 41 41 41 41 41 41 41 41 41 41 41 10 10 10 41 41 41 41 41 41 41 41 41 10 10 10 10 10 10 10 10 10 10 10 41 41 40
40 41 41 41 41 41 41 41 41 41 41 41 41 41 41 41 41 41 41 41 41 41 41 41 10 10 10 41 41 41 41 41 41 41 41 41 41 41 41 41 41 41 41 41 41 41 41 41 41 40
40 41 41 41 41 41 41 41 41 41 41 41 41 41 41 41 41 41 41 41 41 41 41 41 10 10 10 41 41 41 41 41 41 41 41 41 41 41 41 41 41 41 41 41 41 41 41 41 41 40
40 41 41 41 41 41 41 41 41 41 41 41 41 41 41 41 41 41 41 41 41 41 41 41 10 10 10 41 41 41 41 41 41 41 41 41 41 41 41 41 41 41 41 41 41 41 41 41 41 40
40 41 41 10 10 10 10 10 10 10 10 41 41 41 41 41 41 41 41 41 41 41 41 41 10 10 10 41 41 41 41 41 41 41 41 41 41 41 41 41 41 41 41 41 41 41 41 41 41 40
40 41 41 10 10 10 10 10 10 10 10 41 41 41 41 41 41 41 41 41 41 41 41 41 10 10 10 41 41 41 41 41 41 41 41 41 41 41 41 41 41 41 41 41 41 41 41 41 41 40
40 41 41 10 10 10 10 10 10 10 10 41 41 41 41 41 41 41 41 41 41 41 41 41 10 10 10 41 41 41 41 41 41 41 41 41 41 41 41 41 41 41 41 41 41 41 41 41 41 40
40 41 41 10 10 10 10 10 10 10 10 41 41 41 41 41 41 41 41 41 41 41 41 41 10 10 10 41 41 41 41 41 41 41 41 41 41 41 41 41 41 41 41 41 41 41 41 41 41 40
40 41 41 10 10 10 10 10 10 10 10 41 41 41 41 41 41 41 41 41 41 41 41 41 10 10 10 41 41 41 41 41 41 41 41 41 41 41 41 41 41 41 41 41 41 41 41 41 41 40
40 41 41 10 10 10 10 10 10 10 10 10 10 10 10 10 10 10 10 10 10 10 10 10 10 10 10 10 10 10 10 10 10 10 10 10 10 10 10 10 10 10 10 10 10 10 41 41 41 40
40 41 41 10 10 10 10 10 10 10 10 10 10 10 10 10 10 10 10 10 10 10 10 10 10 10 10 10 10 10 10 10 10 10 10 10 10 10 10 10 10 10 10 10 10 10 41 41 41 40
40 41 41 10 10 10 10 10 10 10 10 10 10 10 10 10 10 10 10 10 10 10 10 10 10 10 10 10 10 10 10 10 10 10 10 10 10 10 10 10 10 10 10 10 10 10 41 41 41 40
40 41 41 10 10 10 10 10 10 10 10 41 41 41 41 41 41 41 41 41 41 41 41 41 10 10 10 41 41 41 41 41 41 41 41 41 41 10 10 10 10 10 10 10 10 10 41 41 41 40
40 41 41 10 10 10 10 10 10 10 10 41 41 41 41 41 41 41 41 41 41 41 41 41 10 10 10 41 41 41 41 41 41 41 41 41 41 10 10 10 10 10 10 10 10 10 41 41 41 40
40 41 41 10 10 10 10 10 10 10 10 41 41 41 41 41 41 41 41 41 41 41 41 41 10 10 10 41 41 41 41 41 41 41 41 41 41 10 10 10 10 10 10 10 10 10 41 41 41 40
40 41 41 10 10 10 10 10 10 10 10 41 41 41 41 41 41 41 41 41 41 41 41 41 10 10 10 41 41 41 41 41 41 41 41 41 41 10 10 10 10 10 10 10 10 10 41 41 41 40
40 41 41 10 10 10 10 10 10 10 10 41 41 41 41 41 41 41 41 41 41 41 41 41 10 10 10 41 41 41 41 41 41 41 41 41 41 10 10 10 10 10 10 10 10 10 41 41 41 40
40 41 41 41 41 41 41 41 41 41 41 41 41 41 41 41 41 41 41 41 41 41 41 41 10 10 10 41 41 41 41 41 41 41 41 41 41 10 10 10 10 10 10 10 10 10 41 41 41 40
40 41 41 41 41 41 41 41 41 41 41 41 41 41 41 41 41 41 41 41 41 41 41 41 10 10 10 41 41 41 41 41 41 41 41 41 41 10 10 10 10 10 10 10 10 10 41 41 41 40
40 41 41 41 41 41 41 41 41 41 41 41 41 41 41 41 41 41 41 41 41 41 41 41 10 10 10 41 41 41 41 41 41 41 41 41 41 10 10 10 10 10 10 10 10 10 41 41 41 40
40 41 41 41 41 41 41 41 41 41 41 41 41 41 41 41 41 41 41 41 41 41 41 41 10 10 10 41 41 41 41 41 41 41 41 41 41 10 10 10 10 10 10 10 10 10 41 41 41 40
40 41 41 41 41 41 41 41 41 41 41 41 41 41 41 41 41 41 41 41 41 41 41 41 10 10 10 41 41 41 41 41 41 41 41 41 41 10 10 10 10 10 10 10 10 10 41 41 41 40
40 41 10 10 10 10 10 10 41 41 41 41 41 41 41 41 41 41 41 41 41 41 41 41 10 10 10 41 41 41 41 41 41 41 41 41 41 10 10 10 10 10 10 10 10 10 41 41 41 40
40 41 10 10 10 10 10 10 41 41 41 41 41 41 41 41 41 41 41 41 41 41 41 41 10 10 10 41 41 41 41 41 41 41 41 41 41 10 10 10 10 10 10 10 10 10 41 41 41 40
40 41 10 10 10 10 10 10 41 41 41 41 41 41 41 41 41 41 41 41 41 41 41 41 10 10 10 41 41 41 41 41 41 41 41 41 41 41 41 41 41 41 41 41 41 41 41 41 41 40
40 41 10 10 10 10 10 10 10 10 10 10 10 10 10 10 10 10 10 10 10 10 10 10 10 10 10 41 41 41 41 41 41 41 41 41 41 41 41 41 41 41 41 41 41 41 41 41 41 40
40 41 10 10 10 10 10 10 10 10 10 10 10 10 10 10 10 10 10 10 10 10 10 10 10 10 10 41 41 41 41 41 41 41 41 41 41 41 41 41 41 41 41 41 41 41 41 41 41 40
40 41 10 10 10 10 10 10 10 10 10 10 10 10 10 10 10 10 10 10 10 10 10 10 10 10 10 41 41 41 41 41 41 41 41 41 41 41 41 41 41 41 41 41 41 41 41 41 41 40
40 41 10 10 10 10 10 10 10 10 10 10 10 10 10 10 10 10 10 10 10 10 10 10 10 10 10 41 41 41 41 41 41 41 41 41 41 41 41 41 41 41 41 41 41 41 41 41 41 40
40 41 10 10 10 10 10 10 41 41 41 41 41 41 41 41 41 41 41 41 41 41 41 41 41 41 41 41 41 41 41 41 41 41 41 41 41 41 41 41 41 41 41 41 41 41 41 41 41 40
40 41 10 10 10 10 10 10 41 41 41 41 41 41 41 41 41 41 41 41 41 41 41 41 41 41 41 41 41 41 41 41 41 41 41 41 41 41 41 41 41 41 41 41 41 41 41 41 41 40
40 41 10 10 10 10 10 10 41 41 41 41 41 41 41 41 41 41 41 41 41 41 41 41 41 41 41 41 41 41 41 41 41 41 41 41 41 41 41 41 41 41 41 41 41 41 41 41 41 40
40 41 41 41 41 41 41 41 41 41 41 41 41 41 41 41 41 41 41 41 41 41 41 41 41 41 41 41 41 41 41 41 41 41 41 41 41 41 41 41 41 41 41 41 41 41 41 41 41 40
40 41 41 41 41 41 41 41 41 41 41 41 41 41 41 41 41 41 41 41 41 41 41 41 41 41 41 41 41 41 41 41 41 41 41 41 41 41 41 41 41 41 41 41 41 41 41 41 41 40
40 41 41 41 41 41 41 41 41 41 41 41 41 41 41 41 41 41 41 41 41 41 41 41 41 41 41 41 41 41 41 41 41 41 41 41 41 41 41 41 41 41 41 41 41 41 41 41 41 40
40 40 40 40 40 40 40 40 40 40 40 40 40 40 40 40 40 40 40 40 40 40 40 40 40 40 40 40 40 40 40 40 40 40 40 40 40 40 40 40 40 40 40 40 40 40 40 40 40 40