40 40 40 40 40 40 40 40 40 40 40 40 40 40 40 40 40 40 40 40 40 40 40 40 40 40 40 40 40 40 40 40 40 40 40 40 40 40 40 40 40 40 40 40 40 40 40 40 40 40
40 41 41 41 41 41 41 41 41 41 41 41 41 41 41 41 41 41 41 41 41 41 41 41 41 41 41 41 41 41 41 41 41 41 41 41 41 41 41 41 41 41 41 41 41 41 41 41 41 40
40 41 41 40 40 40 40 40 40 40 41 41 41 41 41 41 41 41 41 41 41 41 41 41 41 41 41 41 41 41 41 41 41 41 41 41 41 41 41 41 41 41 41 41 41 41 41 41 41 40
40 41 41 40 10 10 10 10 10 40 41 41 41 41 41 41 41 41 41 41 41 41 41 41 41 41 41 41 41 41 41 41 41 41 41 41 41 41 41 41 41 41 41 41 41 41 41 41 41 40
40 41 41 40 10 10 10 10 10 40 41 41 41 41 41 41 41 41 41 41 41 41 41 41 41 41 41 41 41 41 41 41 41 41 41 41 41 41 41 41 41 41 41 41 41 41 41 41 41 40
40 41 41 40 10 10 10 10 10 40 40 40 40 40 40 40 40 40 40 40 40 40 40 40 40 40 40 40 40 40 40 40 40 40 40 40 40 40 40 40 40 40 40 40 40 40 40 41 41 40
40 41 41 40 10 10 10 10 10 10 10 10 10 10 10 10 10 10 10 10 10 10 10 10 10 10 10 10 10 10 10 10 10 10 10 10 10 10 10 10 10 10 10 10 10 10 40 41 41 40
40 41 41 40 10 10 10 10 10 40 40 40 40 40 40 40 40 40 40 40 40 40 40 40 40 10 40 40 40 40 40 40 40 40 40 40 40 40 40 40 40 10 10 10 10 10 40 41 41 40
40 41 41 40 10 10 10 10 10 40 41 41 41 41 41 41 41 41 41 41 41 41 41 41 40 10 40 41 41 41 41 41 41 41 41 41 41 41 41 41 40 10 10 10 10 10 40 41 41 40
40 41 41 40 10 10 10 10 10 40 41 41 41 41 41 41 41 41 41 41 41 41 41 41 40 10 40 41 41 41 41 41 41 41 41 41 41 41 41 41 40 10 10 10 10 10 40 41 41 40
40 41 41 40 10 10 10 10 10 40 41 41 41 41 41 41 41 41 41 41 41 41 41 41 40 10 40 41 41 41 41 41 41 41 41 40 40 40 40 40 40 10 10 10 10 10 40 41 41 40
40 41 41 40 40 40 40 40 40 40 41 41 41 41 41 41 41 41 41 41 41 41 41 41 40 10 40 41 41 41 41 41 41 41 41 40 10 10 10 10 10 10 10 10 10 10 40 41 41 40
40 41 41 41 41 41 41 41 41 41 41 41 41 41 41 41 41 41 41 41 41 41 41 41 40 10 40 41 41 41 41 41 41 41 41 40 10 10 10 10 10 10 10 10 10 10 40 41 41 40
40 41 41 41 41 41 41 41 41 41 41 41 41 41 41 41 41 41 41 41 41 41 41 41 40 10 40 41 41 41 41 41 41 41 41 40 10 10 10 10 10 10 10 10 10 10 40 41 41 40
40 41 41 41 41 41 41 41 41 41 41 41 41 41 41 41 41 41 41 41 41 41 41 41 40 10 40 41 41 41 41 41 41 41 41 40 40 40 40 40 40 40 40 40 40 40 40 41 41 40
40 41 41 41 41 41 41 41 41 41 41 41 41 41 41 41 41 41 41 41 41 41 41 41 40 10 40 41 41 41 41 41 41 41 41 41 41 41 41 41 41 41 41 41 41 41 41 41 41 40
40 41 41 41 41 41 41 41 41 41 41 41 41 41 41 41 41 41 41 41 41 41 41 41 40 10 40 41 41 41 41 41 41 41 41 41 41 41 41 41 41 41 41 41 41 41 41 41 41 40
40 41 41 41 41 41 41 41 41 41 41 41 41 41 41 41 41 41 41 41 41 41 41 41 40 10 40 41 41 41 41 41 41 41 41 41 41 41 41 41 41 41 41 41 41 41 41 41 41 40
40 41 41 40 40 40 40 40 40 40 40 41 41 41 41 41 41 41 41 41 41 41 41 41 40 10 40 41 41 41 41 41 41 41 41 41 41 41 41 41 41 41 41 41 41 41 41 41 41 40
40 41 41 40 10 10 10 10 10 10 40 41 41 41 41 41 41 41 41 41 41 41 41 41 40 10 40 41 41 41 41 41 41 41 41 41 41 41 41 41 41 41 41 41 41 41 41 41 41 40
40 41 41 40 10 10 10 10 10 10 40 41 41 41 41 41 41 41 41 41 41 41 41 41 40 10 40 41 41 41 41 41 41 41 41 41 41 41 41 41 41 41 41 41 41 41 41 41 41 40
40 41 41 40 10 10 10 10 10 10 40 41 41 41 41 41 41 41 41 41 41 41 41 41 40 10 40 41 41 41 41 41 41 41 41 41 41 41 41 41 41 41 41 41 41 41 41 41 41 40
40 41 41 40 10 10 10 10 10 10 40 41 41 41 41 41 41 41 41 41 41 41 41 41 40 10 40 41 41 41 41 41 41 41 41 41 41 41 41 41 41 41 41 41 41 41 41 41 41 40
40 41 41 40 10 10 10 10 10 10 40 40 40 40 40 40 40 40 40 40 40 40 40 40 40 10 40 40 40 40 40 40 40 40 40 40 40 40 40 40 40 40 40 40 40 40 41 41 41 40
40 41 41 40 10 10 10 10 10 10 10 10 10 10 10 10 10 10 10 10 10 10 10 10 10 10 10 10 10 10 10 10 10 10 10 10 10 10 10 10 10 10 10 10 10 40 41 41 41 40
40 41 41 40 10 10 10 10 10 10 40 40 40 40 40 40 40 40 40 40 40 40 40 40 40 10 40 40 40 40 40 40 40 40 40 40 40 40 10 10 10 10 10 10 10 40 41 41 41 40
40 41 41 40 10 10 10 10 10 10 40 41 41 41 41 41 41 41 41 41 41 41 41 41 40 10 40 41 41 41 41 41 41 41 41 41 41 40 10 10 10 10 10 10 10 40 41 41 41 40
40 41 41 40 10 10 10 10 10 10 40 41 41 41 41 41 41 41 41 41 41 41 41 41 40 10 40 41 41 41 41 41 41 41 41 41 41 40 10 10 10 10 10 10 10 40 41 41 41 40
40 41 41 40 10 10 10 10 10 10 40 41 41 41 41 41 41 41 41 41 41 41 41 41 40 10 40 41 41 41 41 41 41 41 41 41 41 40 10 10 10 10 10 10 10 40 41 41 41 40
40 41 41 40 10 10 10 10 10 10 40 41 41 41 41 41 41 41 41 41 41 41 41 41 40 10 40 41 41 41 41 41 41 41 41 41 41 40 10 10 10 10 10 10 10 40 41 41 41 40
40 41 41 40 40 40 40 40 40 40 40 41 41 41 41 41 41 41 41 41 41 41 41 41 40 10 40 41 41 41 41 41 41 41 41 41 41 40 10 10 10 10 10 10 10 40 41 41 41 40
40 41 41 41 41 41 41 41 41 41 41 41 41 41 41 41 41 41 41 41 41 41 41 41 40 10 40 41 41 41 41 41 41 41 41 41 41 40 10 10 10 10 10 10 10 40 41 41 41 40
40 41 41 41 41 41 41 41 41 41 41 41 41 41 41 41 41 41 41 41 41 41 41 41 40 10 40 41 41 41 41 41 41 41 41 41 41 40 10 10 10 10 10 10 10 40 41 41 41 40
40 41 41 41 41 41 41 41 41 41 41 41 41 41 41 41 41 41 41 41 41 41 41 41 40 10 40 41 41 41 41 41 41 41 41 41 41 40 10 10 10 10 10 10 10 40 41 41 41 40
40 41 41 41 41 41 41 41 41 41 41 41 41 41 41 41 41 41 41 41 41 41 41 41 40 10 40 41 41 41 41 41 41 41 41 41 41 40 10 10 10 10 10 10 10 40 41 41 41 40
40 41 41 41 41 41 41 41 41 41 41 41 41 41 41 41 41 41 41 41 41 41 41 41 40 10 40 41 41 41 41 41 41 41 41 41 41 40 10 10 10 10 10 10 10 40 41 41 41 40
40 41 40 40 40 40 40 40 41 41 41 41 41 41 41 41 41 41 41 41 41 41 41 41 40 10 40 41 41 41 41 41 41 41 41 41 41 40 10 10 10 10 10 10 10 40 41 41 41 40
40 41 40 41 41 41 41 40 41 41 41 41 41 41 41 41 41 41 41 41 41 41 41 41 40 10 40 41 41 41 41 41 41 41 41 41 41 40 40 40 40 40 40 40 40 40 41 41 41 40
40 41 40 41 41 41 41 40 41 41 41 41 41 41 41 41 41 41 41 41 41 41 41 41 40 10 40 41 41 41 41 41 41 41 41 41 41 41 41 41 41 41 41 41 41 41 41 41 41 40
40 41 40 41 41 41 41 40 40 40 40 40 40 40 40 40 40 40 40 40 40 40 40 40 40 10 40 41 41 41 41 41 41 41 41 41 41 41 41 41 41 41 41 41 41 41 41 41 41 40
40 41 40 41 41 41 41 10 10 10 10 10 10 10 10 10 10 10 10 10 10 10 10 10 10 10 40 41 41 41 41 41 41 41 41 41 41 41 41 41 41 41 41 41 41 41 41 41 41 40
40 41 40 41 41 41 41 10 10 10 10 10 10 10 10 10 10 10 10 10 10 10 10 10 10 10 40 41 41 41 41 41 41 41 41 41 41 41 41 41 41 41 41 41 41 41 41 41 41 40
40 41 40 41 41 41 41 40 40 40 40 40 40 40 40 40 40 40 40 40 40 40 40 40 40 40 40 41 41 41 41 41 41 41 41 41 41 41 41 41 41 41 41 41 41 41 41 41 41 40
40 41 40 41 41 41 41 40 41 41 41 41 41 41 41 41 41 41 41 41 41 41 41 41 41 41 41 41 41 41 41 41 41 41 41 41 41 41 41 41 41 41 41 41 41 41 41 41 41 40
40 41 40 41 41 41 41 40 41 41 41 41 41 41 41 41 41 41 41 41 41 41 41 41 41 41 41 41 41 41 41 41 41 41 41 41 41 41 41 41 41 41 41 41 41 41 41 41 41 40
40 41 40 40 40 40 40 40 41 41 41 41 41 41 41 41 41 41 41 41 41 41 41 41 41 41 41 41 41 41 41 41 41 41 41 41 41 41 41 41 41 41 41 41 41 41 41 41 41 40
40 41 41 41 41 41 41 41 41 41 41 41 41 41 41 41 41 41 41 41 41 41 41 41 41 41 41 41 41 41 41 41 41 41 41 41 41 41 41 41 41 41 41 41 41 41 41 41 41 40
40 41 41 41 41 41 41 41 41 41 41 41 41 41 41 41 41 41 41 41 41 41 41 41 41 41 41 41 41 41 41 41 41 41 41 41 41 41 41 41 41 41 41 41 41 41 41 41 41 40
40 41 41 41 41 41 41 41 41 41 41 41 41 41 41 41 41 41 41 41 41 41 41 41 41 41 41 41 41 41 41 41 41 41 41 41 41 41 41 41 41 41 41 41 41 41 41 41 41 40
40 40 40 40 40 40 40 40 40 40 40 40 40 40 40 40 40 40 40 40 40 40 40 40 40 40 40 40 40 40 40 40 40 40 40 40 40 40 40 40 40 40 40 40 40 40 40 40 40 40